#
# name <tab> abbrev <tab> shapefile <tab> thresholdKm
# thresholdKm of 0 means unlimited
#
Abbot Point	ABP	abbot_point_visit_pl.zip	0
Adelaide	ADL	adelaide_visit_pl.zip	0
Albany	ALB	albany_visit_pl.zip	0
Barrow Island	BWB	barrow_island_visit_pl.zip	0
Bell Bay	BEL	bell_bay_visit_pl.zip	0
Brisbane	BNE	brisbane_visit_pl.zip	0
Broome	BME	broome_visit_pl.zip	0
Bunbury	BUY	bunbury_visit_pl.zip	0
Burnie	BWT	burnie_visit_pl.zip	0
Cairns	CNS	cairns_visit_pl.zip	0
Cape Preston	CPN	cape_preston_visit_pl.zip	0
Dampier	DAM	dampier_visit_pl.zip	0
Devonport	DPO	devonport_visit_pl.zip	0
Esperance	EPR	esperance_visit_pl.zip	0
Fremantle	FRE	fremantle_visit_pl.zip	0
Geelong	GEX	geelong_visit_pl.zip	0
Geraldton	GET	geraldton_visit_pl.zip	0
Gladstone	GLT	gladstone_visit_pl.zip	0
Gove	GOV	gove_visit_pl.zip	0
Hay Point	HPT	hay_point_visit_pl.zip	0
Hobart	HBT	hobart_visit_pl.zip	0
Kurnell	KUR	kurnell_visit_pl.zip	0
Kwinana	KWI	kwinana_visit_pl.zip	0
Mackay	MKY	mackay_visit_pl.zip	0
Melbourne	MEL	melbourne_visit_pl.zip	0
Milner Bay	MIL	milner_bay_visit_pl.zip	0
Newcastle	NTL	newcastle_visit_pl.zip	0
Port Alma	PTL	port_alma_visit_pl.zip	0
Port Botany	PBT	port_botany_visit_pl.zip	0
Port Hedland	PHE	port_hedland_visit_pl.zip	0
Port Kembla	PKL	port_kembla_visit_pl.zip	0
Port Latta	PLA	port_latta_visit_pl.zip	0
Port Walcott	PWL	port_walcott_visit_pl.zip	0
Portland	PTJ	portland_visit_pl.zip	0
Sydney	SYD	sydney_visit_pl.zip	0
Thevenard	THE	thevenard_visit_pl.zip	0
Townsville	TSV	townsville_visit_pl.zip	0
Weipa	WEI	weipa_visit_pl.zip	0
Whyalla	WAY	whyalla_visit_pl.zip	0